R 1440 810
SO ./textures/greystone.xpm
WE ./textures/mossy.xpm
NO ./textures/colorstone.xpm
EA ./textures/bluestone.xpm

S ./textures/barrel.xpm

F 156, 204, 156000
C 195, 200, 255

1111111 1111111 1111111 1111111
1200021 1200111 1020201 1101011
1110111 1110111 1010101 1010101
1110111 1110111 1000001 1102011
1200021 1110021 1010101 1010101
1110111111101111100000111100011
1110111112001111111011111110111
1110222211101111111011111110111
12E0000000000000000000000000021
1110222211101111111011111110111
1110111112001111111011111110111
1110111111101111100000111100011
1200021 1110021 1010101 1010101
1110111 1110111 1000001 1102011
1110111 1110111 1010101 1010101
1200021 1200111 1020201 1101011
1111111 1111111 1111111 1111111