R 1440 810
SO ./textures/greystone.xpm
WE ./textures/mossy.xpm
NO ./textures/colorstone.xpm
EA ./textures/bluestone.xpm

S ./textures/barrel.xpm

F 156, 204, 156
C 195, 200, 255

111111111111111111111111111111111111111111
100000000000000000000000000000000002000001
100000000000000000000000000000000020000001
100000000000000000000000000000000200000001
100000000000000000000000000000002000000001
100000000000000001110000000000020000000001
100000000000000001110000000000200000000001
100000000000000001110000000002000000000001
100000000000000001110000000020000000000001
100000000000000000000000000200000000000001
100000000000000000000000002000000000000001
100000000000000000000000000000000000000001
100000000000000000000000000000000000000001
100000000000000000000000000000000000000001
100000000000000000000000000000000000000001
100000000000000000000000000000000000000001
100000000000000000000000000000000000000001
100000001111110000000000000000001111110001
100110001111110001111000000000001111110001
100110001111110001111000000000001111110001
100110001111110001111000000000001111110001
100000000000000000000000000000000000000001
100000000000000000000000000000000000000001
100000000000000000000000000000000000000001
100000000000022222200000000000000000000001
100000000000000000000000000000000000000001
100000000000000000000000000000002220000001
100000000000000000000000000000000020000001
100022200000000000000000000000000000000001
100022200000000000000000000N00000020000001
100022200000000000000000000000002220000001
111111111111111111111111111111111111111111