R 800 800

NO ./textures/bluestone.xpm
SO ./textures/colorstone.xpm
WE ./textures/greystone.xpm
EA ./textures/pillar.xpm
S ./textures/barrel.xpm
F 124, 142, 12
C 12, 220, 125

1111111111
1000000001
111100E001
1000000001
1000001001
1020001001
1000001001
1111111111